




11            11
11            11
11            11
11            11
11            11
1111111111111111
1111111111111111